11111111111111
10C0E000P00001
11111111111111
