1111111111111111111111111111111111
1P000100000001C10C00C0000000000011
1111010100100000111001000000010101
1E000000C00C0000000000000000000111
1000000000000000000000000000000C11
11111CCCCCCCCCCCCCCCCCCCCCCCC11111
1111111111111111111111111111111111
