1111111111111111111111111111111111
1E11P1000000001C10C00C000000000001
1011010100100010111001000000010101
10000000C00C0000000000000000000111
1000000000000000000000000000000C11
11111CCCCCCCCCCCCCCCCCCCCCCCC11111
1111111111111111111111111111111111
