11111111111111111111
1PEC1111111111111111
11111111111111111111