1111111
1PEC111
1111111
1111111
1111111
1111111