111111111111
1P000E000001
111C00011111
111111111111